NO ./path_to_the_north_texture
SO ./path_to_the_south_texture
WE ./path_to_the_west_texture
EA ./path_to_the_east_texture

F 220,100,0
C 225,30,0

        1111111111111111111111111
111111111000000000110000000000001
        1011000001110000000000001
        1001000000000000000000001
111111111111000001110000000000001
100000000011000001110111111111111
11110111111111011100000000001
11110111111111011101010000001
11000001111101011100001111111
1000000001000001100001000001
1000000001000001101011000101
110000011101010111110110000111
11110111 1110101 101111000111
11111111 1111111 111111111111