NO ./assets/img1.xpm
SO ./assets/img2.xpm
WE ./assets/img3.xpm
EA ./assets/img4.xpm

F 220,100,0
C 225,30,0


        1111111111111111111111111
        1000000000110000000000001
        10100N0001110011110000001
        10000000000001    1000001
        1000000001110011110000001
        1111111111111111111111111