NO ./path_to_the_north_texture
SO ./path_to_the_south_texture
WE ./path_to_the_west_texture
EA ./path_to_the_east_texture

F 2201000
C 225300


111111111111111111111111
100000000000000000001111
101111111110000000101111
101000010000100000101001
101011110111011111100001
100000000000000000000001
100000000000000000000001
100000000000000000000001
100000000000100000000001
100000000000010000001001
100000N00000000000001001
100000000000000000001001
100000000000000000001001
100000000000000000001001
100000000000000000000001
100000000000000000000001
100000000000000000000001
100000000000000000000001
100000000000000010000001
100000000000000000000001
100000000000000000000001
100000001111000000000001
100000000000000000000001
111111111111111111111111