SO ./assets/img2.xpm
WE ./assets/img3.xpm
NO ./assets/img1.xpm
EA ./assets/img4.xpm

F  235, 52, 52
C  105,125,50 

        1111111111111111111111111
         1000000000110000000000001
         1011000001110000000000001
1111111111000000000000001111111111
111111111011000001110000000000001
100000000011000001110111111111111
11110111111111011100000010001
1111011111111101110101110001
110000001101010111001   100011
100000N0000000001100011110001
10000000000000001101010010101
1100000111010101111101111101111
11110111 1110101 101111010101
11111111 1111111 111111111111