NO ./assets/img1.xpm
SO ./assets/img2.xpm
WE ./assets/img3.xpm
EA ./assets/img4.xpm

F 155,255,155
C 155,255,155

         1111111111111111111111111
         1000000000110000000000001
         1011000001110000000000001
1111111111000000000000001111111111
111111111011000001110000000000001
100000000011000001110111111111111
11110111111111011100000010001
11110111111111011101010010001
11000000110101011100000010001
100000N0000000001100000010001
10000000000000001101010010101
1100000111010101111101111101111
11110111 1110101 101111010101
11111111 1111111 111111111111